[file]
tilesetIso.png

[nTiles]
7

[width]
114

[height]
57

[rows]
15 

[columns]
15

[matrix]
5 5 5 5 5 5 5 5 5 5 5 5 5 5 5
5 5 5 3 0 3 0 1 0 3 0 3 5 5 5
5 5 3 0 3 0 3 0 3 0 3 0 3 5 5
5 3 0 3 0 3 0 3 0 3 0 3 0 3 5
5 0 3 0 3 0 3 0 3 0 3 0 3 0 5
5 1 0 3 0 3 0 3 0 3 0 3 0 1 5
5 5 1 0 3 0 3 1 3 0 3 0 1 5 5
5 5 5 1 0 3 0 0 0 3 0 1 5 5 5
5 5 1 0 3 0 3 1 3 0 3 0 1 5 5
5 1 0 3 0 3 0 3 0 3 0 3 0 1 5
5 0 3 0 3 0 3 0 3 0 3 0 3 0 5
5 3 0 3 0 3 0 3 0 3 0 3 0 3 5
5 5 3 0 3 0 3 0 3 0 3 0 3 5 5
5 5 5 3 0 3 0 1 0 3 0 3 5 5 5
4 4 4 4 4 4 4 4 4 4 4 4 4 4 4

[rowInicialPosition]
7

[columnInicialPosition]
7